///////////////
/............./
/.B.B.B.B.B.B./
/.B.B.BSB.B.B./
/.B.B.....B.B./
/.....B.B...../
/S.BB.....BB.S/
/.....B.B...../
/.....BBB...../
/.B.B.B.B.B.B./
/.B.B.B.B.B.B./
/.B.B.....B.B./
/.....BBB...../
/.....BHB...../
///////////////