///////////////
/............./
/.SLLL.BB.SWWL/
/.SLLL.BSB.B.L/
/.BBBL.......L/
/.BB.LBBB....L/
/SBB.LLLLSBBBB/
/WW...B.B..BB./
/....SS......./
/SB.B.BBB.LLLW/
/.B.B...B.LLLW/
/.B.........LL/
/.B...BBB....B/
/.....BHB...BB/
///////////////