///////////////
/............./
/.S.BL.BB.SWWL/
/.S.BLLBS..B.L/
/.B.BL.......L/
/.....BBB....L/
/SBB.LLLLSBB../
/WW...B.B..B../
/....SS......./
/SB.B.BWB.LBBW/
/.B.B...B.LLLW/
/.B.........LL/
/.B...BBB....B/
/.....BHB...BB/
///////////////