///////////////
/............./
/LB.B.B.B.B.BL/
/LB.B.BSB.B.BL/
/LB.B.....B.BL/
/L....B.B....L/
/S.BB.....BB.S/
/.....B.B...../
/.....BBB...../
/.B.B.W.W.B.B./
/.B.B.B.B.B.B./
/.B.B.....B.B./
/.....BBB...../
/.....BHB...../
///////////////