///////////////
/............./
/.SBBB..BBB.SB/
/...B.....B.../
/..LLSBBS.BLS./
/LLL..B....L../
/..S..BBBLLL../
/.WW........../
/.WB...BBBBBS./
/LLB.WSB....BL/
/..........WBL/
/LLS.......WLL/
/.....BBB...../
/SB...BHB...BS/
///////////////