///////////////
/............./
/.SBBB..BBB.S./
/...B.....B.../
/..LLSB.S.BLS./
/LLL.......L../
/..S..BBBLLL../
/.WW........../
/.WB...BBBBBS./
/LLB.WS.....BL/
/.....LLL..WBL/
/LLS.......WLL/
/.....BBB...../
/SB...BHB...BS/
///////////////