///////////////
/............./
/.SLLL.BB.SWWL/
/.SLLL.BSB.B.L/
/.BBBL.......L/
/....LBBB....L/
/SBB.LLLLSBB.B/
/WW...B.B..B../
/....SS......./
/SB.B.BBB.LLLW/
/.B.B...B.LLLW/
/.B.........LL/
/.B...BBB....B/
/.....BHB...BB/
///////////////